111111111111111111111111111
1C0000C00000000000C00000001
1P0111111111110111111111101
1E010000C000C00000C00000001
100001111111110111111111101
10010000C00000C000000000001
10C111111111110111111111101
10100000000000C000000000001
1011111111111101111111111C1
10C0000000C000C000000000C01
111111111111111111111111111
